################
############   #
#              #
#              #
#              #
#              #
#              #
############ ###