#          #
#          #
#          #
#          #
#          #
#          #############
                        #
                        #
                        #
#        ################
#########################