                                     #######
                                    #       #
                                    #       #
                                    #       #
                                    #       #
    #####  ##########################       #
   #    ###   #     #                       #
   #                                        #
   #          #     #                       #
   #    #     ############                  #
   #    #     #                             #
    ###       #                             #
      #       #                             #
       #####  #########################  ###
           #  #
           #  #
           #  #
           #
 ###########  #
#             #
#             #
#             #
#             #
#             #
#             #
#             #
#             #
#             #
#             #
#            #
#            #
#             #
#             #
#             #
#             #
#             #
#             #
#             #
#             #
#             #
#             #
#             #
#             #
#             #
 ######       #
      #       #
      #       #
      #       #
       #######