#################
#               #
#               #
#               #
#               #
#               #
#               #
#               #
#               #
#############  ##