           ################## ##################
           #                                   #
                                               #
           #                                   #
           #                                   #
           #                                   #
           #                                   #
           #                                   #
           #                                   #
           #                                   #
           #                                   #
           #                                   #
           #                                   #
           #                                   #
###########                                    ####################
#                                                                 #
#                                                                 #
#                                                                 #
#                                                                 #
#                                                                 #
###################################################################