#################
#     #         #
#     #         #
#     #         #
## ####         #
#     #         #
#               #
#### ############