###########################PP################
##########################FFFFFFFFFFFFFFFFFF#
######PP######F####F#####FFFFFFFFFFFFFFFFFFF#
#FFFFFFFFFFFFFFFFFFFFFFFFFFFFFFFFFFFFFFFFFFF#
#FFFFFFFFFFFFFFFFFFFFFFFFFFFFFFFFFFFFFFFFFFF#
#FFFFFFFFFFFFFFFFFFFFFFFFFFFFFFFFFFFFFFFFFFF#
#FFFFFFFFFFFFFFFFFFFFFFFFFFFFFFFFFFFFFFFFFFF#
#FFFFFFFFFFFFFFFFFFFFFFFFFFFFFFFFFFFFFFFFFFF#
#FFFFFFFFFFFFFFFFFFFFFFFFFFFFFFFFFFFFFFFFFFF#
#FFFFFFFFFFFFFFFFFFFFFFFFFFFFFFFFFFFFFFFFFFF#
#FFFFFFFFFFFFFFFFFFFFFFFFFFFFFFFFFFFFFFFFFFF#
#FFFFFFFFFFFFFFFFFFFFFFFFFFFFFFFFFFFFFFFFFFF#
#FFFFFFFFFFFFFFFFFFFFFFFFFFFFFFFFFFFFFFFFFFF#
#FFFFFFFFFFFFFFFFFFFFFFFFFFFFFFFFFFFFFFFFFFF#
#FFFFFFFFFFFFFFFFFFFFFFFFFFFFFFFFFFFFFFFFFFF#
#FFFFFFFFFFFFFFFFFFFFFFFFFFFFFFFFFFFFFFFFFFF#
#############################################