############MMM#
############MMM#
#MMMMMMMM#MMMMM#
#MMMMMMMM#MMMMM#
#MMMMMMMMMMMMMM#
#MMMMMMMMMMMMMM#
#MMMMMMMM#MMMMM#
############P###