#dDDDd#
#dDDDd#
#dDDDd#
#dDDDd#
#dDDDd#
#dDDDd#######
DDDDDDDDDDDD#
DDDDDDDDDDDD#
dddddddddddd#
DDDDDDDDDDDD#
DDDDDDDDDDDD#
#DDDDD#######