################
################
#MMMM#MMMMMMMMM#
#MMMM#MMMMMMMMM#
#MMMM#MMMM#MMMM#
#MMMMMMMMMMMMMM#
#MMMMMMM#MMMMMM#
#MMMMMMM#MMMMMM#
#MMMMMMM#MMMMMM#
#MMMMMMM#MMMMMM#
#MMMMMMMMMMMMMM#
##########PP####