           ##################P##################
           #CCCCCCCCCCCCCCCDDDDDCCCCCCCCCCCCCCC#
           PCCCCCCCCCCCCCCCCCCCCCCCCCCCCCCCCCCCP
           #CCCCCCCCCCCCCCCCCCCCCCCCCCCCCCCCCCC#
           #CCCCCCCCCCCCCCCCCCCCCCCCCCCCCCCCCCC#
           #CC#############CCCCC#CCCCC#######CC#
           #CC#GGGGGGGGGGG#CCCCC#GGGGGGGGGGG#CC#
           #CC#GGGGGGGGGGG#CCCCC#GGGGGGGGGGG#CC#
           #CC#GGGGGGGGGGG#CCCCC#GGGGGGGGGGG#CC#
           #CC#GGGGGGGGGGGCCCCCCCGGGGGGGGGGG#CC#
           #CC#GGGGGGGGGGGCCCCCCCGGGGGGGGGGG#CC#
           #CC#GGGGGGGGGGG#CCCCC#GGGGGGGGGGG#CC#
           #CC#GGGGGGGGGGG#CCCCC#GGGGGGGGGGG#CC#
           #CC#GGGGGGGGGGG#CCCCC#GGGGGGGGGGG#CC#
############CC#GGGGGGGGGGG#CCCCC#GGGGGGGGGGG#CC####################
#DDDDDDDDDDDDDDDDDDDDDDDDDDDDDDDDDDDDDDDDDDDDDDDDDDDDDDDDDDDD!!!DD#
#DDDDDDDDDDDDDDDDDDDDDDDDDDDDDDDDDDDDDDDDDDDDDDDDDDDDDDDDDDDDDDDDD#
#ddddddddddddddddddddddddddddddddddddddddddddddddddddddddddddddddd#
#DDDDDDDDDDDDDDDDDDDDDDDDDDDDDDDDDDDDDDDDDDDDDDDDDDDDDDDDDDDDDDDDD#
#DDDDDDDDDDDDDDDDDDDDDDDDDDDDDDDDDDDDDDDDDDDDDDDDDDDDDDDDDDDDDDDDD#
###################################################################