#################
#MMMMM#MMMMMMMMM#
#MMMMM#MMMMMMMMM#
#MMMMM#MMMMMMMMM#
##M####MMMMMMMMM#
#MMMMM#MMMMMMMMM#
#MMMMMMMMMMMMMMM#
####P############