##########
##########
#O        #
#.  Z.   ##
#   OO   ##
#   ..   ##
#O       ##
#.       ##
#### #####
##########