################
############   #
# O   Z. #B    #
# .      #.    #
#           b..#
#              #
# Z.   Z.#     #
############ ###