#######
#     #
#     #
#     #
#     #
#     #######
            #
            #
            #
            #
            #
#     #######
#############