################
################
#   K#B    Db..#
#   K#.        #
#   K#  F.#F.F.#
#              #
#     Z.#O  K O#
#Z.     #.    .#
#     Z.#O  K O#
#Z.     #.    .#
#              #
##########  ####