###########
###########
#TiTiTi S #
# i i i   #
#          
#         #
###########