#################
#   TS#         #
#     #C       B#
#     #        .#
## ####         #
#     #       E.#
#               #
#### ############